1_9_1 1_1_1 2_3_1 1_9_1 1_4_1
1_6_1 0 2_9_1 0 1_8_1
1_3_1 2_3_1 2_1_1 2_4_1 1_8_1
1_6_1 0 2_9_1 0 1_4_1
1_8_1 2_4_1 2_3_1 2_9_1 1_1_1
0 1_9_1 2_8_1 1_9_1 0