1_6_1 1_1_1 1_5_1 1_1_1
1_6_1 1_5_1 1_6_1 1_4_1
1_9_1 64_1_1+5_1+1_1 63_9_1+4_1 1_4_1
1_5_1 1_4_1 1_6_1 1_9_1
1_4_1 1_9_1 1_9_1 1_5_1