1_6_1 1_12_1 1_1_1 1_12_1 1_7_1
1_5_1 1_11_1 0 1_12_1 1_6_1
1_1_1 2_5_1 2_5_1 2_1_1 1_11_1
1_12_1 2_6_1 2_12_1 2_12_1 1_6_1
1_7_1 2_11_1 2_11_1 2_1_1 1_7_1
1_6_1 2_11_1 2_7_1 2_12_1 1_1_1