1_11_1 1_4_1 1_11_1 1_10_1
1_7_1 1_4_1 1_9_1 1_7_1
1_11_1 0 0 1_11_1
1_8_1 1_10_1 0 1_4_1
1_4_1 1_9_1 1_8_1 1_8_1
1_11_1 1_7_1 1_9_1 1_10_1