1_1_1 1_1_1 1_7_1 1_3_1
0 1_7_1 1_4_1 0
1_1_1 1_6_1 1_1_1 1_1_1
0 6_3_1 1_3_1 0
2_4_1 2_3_1 2_1_1 2_6_1
1_4_1 1_6_1 1_7_1 1_6_1
1_1_1 1_7_1 1_1_1 1_7_1
0 1_6_1 1_4_1 0