1_4_1 1_6_1 1_9_1 1_4_1 1_4_1
1_6_1 1_4_1 1_11_1 1_11_1 1_9_1
1_9_1 1_6_1 1_4_1 1_3_1 1_3_1
1_11_1 61_3_1+6_1+9_1+3_1 1_3_1 0 61_4_1+11_1+11_1
1_3_1 1_6_1 1_11_1 1_4_1 1_9_1