1_13_1 1_11_1 1_13_1 1_4_1 1_13_1
1_12_1 0 2_13_1 0 1_1_1
1_13_1 1_4_1 2_13_1 1_6_1 1_1_1
1_11_1 0 2_4_1 0 1_11_1
1_13_1 1_11_1 2_6_1 1_1_1 1_12_1
1_13_1 0 2_4_1 0 1_4_1
1_11_1 1_13_1 2_4_1 1_1_1 1_13_1
0 2_13_1 0 2_11_1 0