1_11_1 62_11_1+11_1+10_1 62_4_1+3_1+9_1 62_11_1+3_1+11_1 1_4_1
1_9_1 1_3_1 1_6_1 1_11_1 1_11_1
1_11_1 1_4_1 1_6_1 1_10_1 1_11_1
1_9_1 0 1_11_1 0 1_4_1
1_6_1 1_9_1 1_11_1 1_9_1 1_6_1
0 1_3_1 1_6_1 1_10_1 0