1_5_1 64_1_1+5_1+11_1 0 1_11_1
1_1_1 1_4_1 1_5_1 1_4_1
1_1_1 1_11_1 1_5_1 1_11_1
1_4_1 1_1_1 1_4_1 1_5_1
1_5_1 1_4_1 1_1_1 1_11_1