1_7_1 1_5_1 1_9_1 1_7_1 1_9_1
1_1_1 1_1_1 0 0 1_1_1
1_9_1 1_5_1 1_1_1 1_9_1 1_7_1
1_6_1 0 0 1_1_1 1_6_1
1_6_1 1_5_1 1_6_1 1_1_1 64_6_1+5_1+7_1+9_1