1_3_1 2_5_1 0 0 2_4_1 1_3_1
1_3_1 2_8_1 0 0 2_1_1 1_8_1
1_5_1 2_1_1 0 0 2_1_1 1_9_1
1_4_1 2_9_1 0 0 2_5_1 1_4_1
1_3_1 2_3_1 1_4_1 1_1_1 2_8_1 1_3_1
0 1_9_1 1_5_1 1_5_1 1_13_1 0